15
10
1001110010111000100010101010101010101100
0101000110100110011110011010110010110100
0101011110011010101001101101001111000101
0001101001101011100010100110100101100101
0101100110001100010110011010011011010101
0101011101010101010100111010110000110100
0011110001010101001110101100001111000101
1001011001010011101010100010110001010111
0011110001011011101011001101010100111100
1101001100001110100101100101010111010101
0001101001101001011010110010001001000101
0101101111000011101010101100101101100001
0011110000011010101011000011101011000101
1001011001111001110000011100100101100101
0011101010100110001101100111001110100110
11
10