15
10
1011101010101010100010101010101010101100
1001110010011010011010011100110110010110
0101010101011001101001100011011000111000
0101010101010101100110101100100110100110
0101001101100101001111000101010110111100
0101110110010000111001010011011010010100
0101001101100001101001101001110001010101
0011101011000011100010100110001101100101
1001101001101101010110011100100111100101
0001110010110000011001010101000110100110
0101001111000111100101100101010110011110
0011110000111010000011100101010100111100
1011011010011110011110010110001111000101
1001101001101001110000111010110000110100
0011101010100110001110101010011010110110
2
10