15
10
1011100010101000101011101001110010011100
1001010010110110100110100110001101100101
0101011110011010001010101110100110100100
0011101000101100100110101100010111010001
1001110010110110010111010011011000010110
0101000110101010011000111000110000111100
0101010110011010101011000101001111000101
0101011101011001110001010101100101100101
0101100101100101001101100101010110010110
0011011011010011101011100101010101011101
1001101000101010110010010100010100110100
0001101011001001011001110101001111100101
0101110101010011101010100110100110100110
0011010000111100100110101100010110011100
1011001011100011001011100011001001100111
3
10