15
10
1011101010001110100110101000101010101110
1001101001101001011010010100100110101100
0101100110100110100101100111011111010101
0101001111001101001110101010101000100110
0001110000110010101011001001110010011100
0101001110101000111001010101010101110101
0101100111000011101001100101001110100100
0101011101011001101010000110100111000101
0011110001010101110100111100011100010110
1101010100110010001011000011110000111100
0101001110101100100101101101001111000101
0101100110100110001110100100100101100001
0001011010011010100011000101010110110100
0101101101101001011001010111001111000101
0011101010100110101100101010101001100111
11
10